11111111111
1C000000001
110000P1C01
1000C111101
10C000000C1
100E0C01001
11111111111