111111111
10C000P01
1C0000001
1100C1001
100E000C1
10010C001
111111111