1111111111111111111111111111
10C0001C100001110C00000C1101
100000P0C110000C10C0000100C1
10E00000111C000C000001110C11
100000111C000000011CCCC00011
100111C000000011000C00C10101
1000011000010001010CCCC10101
10C0010000000C01C00C00C01011
111000111C000C11100C00CC11C1
111C000000C00C00100C00CE0101
10C000C00000C0C00001100C0001
1111111111111111111111111111